
-----------------------------
|   君を見ているよ        |  \
|                           |___\
|      _  _                     |
|    _(_)(_)_                   |
|   (_).--.(_)                  |
|     /    \                    |
|     \    /                    |
|      '--'                     |
|_______________________________|

