
     _________________
    |    |_.---._|___|
  _ |   o| |   | |_o_|
 | ||    |/|   |\|   |
 |_||____|`\___/'|___|
             V
           _/-\_
