
---------------------------------
|   You surprise me             | \
|   You may find these useful   |  \
|                               |___\
|      _  _                         |
|    _(_)(_)_                       |
|   (_).--.(_)                      |
|     /    \                        |
|     \    /                        |
|      '--'                         |
|___________________________________|
