   o=(=(=(=(=(=(-)=)=)=)=)=)=o
     !-'-'-'-/_____\-'-'-'-!
     ! !  , /___|___\`  ! !!
     !!! , /    |    \`  ! !
     !!  ,|_____|_____`  !!!
     !_,| |___________|` `_!
     !-`| |           | |,-!
     !!!! |           | ! !!
     !!!! |           | !!!!
     !!!!_|___________|_!!!!
     !!!!_______________!!!!
     !!!!               !!!!
     !!!!               !!!!
